[20,35]
(3,7)
(33,18)
(2,0,2,2)
(8,0,1,2)
(10,0,1,1)
(2,3,1,2)
(3,4,3,1)
(9,3,1,1)
(8,4,2,1)